11
8
22 22 22 22 22 22 22 22 22 22 22
22 4 0 0 0 0 0 0 0 3 22
22 4 0 0 0 0 0 0 0 3 22
22 4 0 0 23 24 25 0 0 3 22
22 4 0 0 0 0 0 0 0 3 22
22 4 0 0 23 24 25 0 0 3 22
22 4 0 0 0 0 0 0 0 3 22
22 21 21 21 21 21 21 21 21 21 22